11111
1P0E1
1CCC1
1CCC1
1CCC1
1CCC1
1CCC1
1CCC1
1CCC1
1CCC1
1CCC1
1CCC1
1CCC1
1CCC1
1CCC1
1CCC1
1CCC1
1CCC1
1R001
11111
11111
11111
11111
11111
11111
